############
#####      #
##### $ @$.#
#######  ###
####### .###
############
############
############
