##########
##########
##########
##########
##.$ ##.##
#    . $##
# $   #@##
####  ####
##########
##########
