##########
###   ####
##. $@##*#
### * ####
###  #####
##########
##########
##########
##########
##########
