##########
##    ####
##$# *####
## . $@###
##.#######
##########
##########
##########
##########
##########
