##########
##########
##########
##########
##########
#@$ .#####
#  #######
##########
##########
##########
