##########
##########
#.$ ######
# @ ######
#**#######
##########
##########
##########
##########
##########
