##########
#.$@######
#  #######
# ########
#  #######
# $*######
#.  ######
#   ######
#  #######
##########
