##########
##########
##########
#######  #
#######$ #
#######  #
##  ###  #
##.@     #
## $.#####
##########
