##########
#  ##*####
#@$#######
## #######
## #######
## #######
## #######
#  #######
#       .#
##########
