##########
#####.####
#####    #
#####.   #
#####$   #
#####@ # #
###### # #
###### $ #
######  ##
##########
