##########
#  #######
#$ #######
#  #######
#  #######
# @#######
# $.######
#  #######
#. #######
##########
