##########
##########
####@    #
###.*### #
#### ### #
##### ## #
###### # #
###### $ #
######   #
##########
