##########
##########
####*#####
#. #######
#  #######
# ########
# ########
#    $@###
#  #######
##########
