##########
#######@##
#######*##
##      ##
## ####  #
## ####  #
## ####  #
##*#######
##########
##########
