##########
##########
####@#####
####$#####
#### #####
#### #*###
###  ###.#
###      #
#######  #
##########
