##########
##########
##########
##########
##########
####.#####
#### #####
#* $    *#
#@   ##  #
##########
