##########
#.########
# ########
# ########
# ########
# @#######
# $  .####
#  $ #####
#  ###*###
##########
