##########
###  #####
## $ #####
## $  ####
## .  ####
##    ####
######.###
##########
##########
##########
