##########
# . #. $@#
#      ###
#  #######
# $#######
#  #######
##########
##########
##########
##########
