##########
##########
#######@##
#######$##
####### ##
##  ### ##
# $ ##.  #
#        #
##   .  ##
##########
