##########
##########
##########
##########
##########
##########
##########
###  #####
#@$ .##*##
##########
