##########
#####*####
##########
##########
##########
######.  #
#######  #
#######$ #
#######@ #
##########
