##########
##########
##########
##########
# $ .#####
#  ###  ##
# ##@$  ##
#       ##
####.$ .##
##########
