##########
#  #######
#@$#######
## #######
## #######
#  ###.###
#      ###
###*#  ###
##########
##########
