##########
###  #####
###$+#####
##*. #####
##   #####
#  # #####
# ## #####
# $  #####
###  #####
##########
