##########
##########
# .#######
#  #######
## #######
## #######
## #######
# $####*##
# @#######
##########
