##########
#####  ###
##   $ ###
##$ #.   #
## ##### #
## ##### #
## ####*@#
## #######
##.#######
##########
