##########
##########
##########
#  .######
#     ####
# $ *@####
#   ######
##  ######
##  ######
##########
