##########
##@###.###
# $    ###
#   .  ###
#####  ###
#####  ###
#####  ###
##### $###
#####  ###
##########
