##########
##########
##########
#####*####
#  #######
#   ######
#   ######
#.     $@#
##  ######
##########
