##########
#####  ###
#####$  ##
#####.. .#
######   #
#######  #
####### $#
####### $#
####### ##
##########
