##########
####  ####
# $   ####
# @ .  * #
#####    #
##########
##########
##########
##########
##########
