##########
#     ####
#$.## ####
#      $@#
#   .  $ #
#.########
##########
##########
##########
##########
