##########
## @  ####
## $  ####
#*### ####
##### ####
##### ####
####  ####
####   .##
##########
##########
