##########
######  ##
#@$     ##
####### ##
####### ##
#######.##
##########
##########
####*#####
##########
