##########
#####*.  #
######   #
####### ##
######* ##
######@ ##
######  ##
###### $##
######  ##
##########
