##########
##########
#.     $@#
#  ####  #
##########
######*###
##########
##########
##########
##########
