##########
#.########
# ########
#$########
#  #######
# $ ######
#.#     ##
####### *#
####### @#
##########
