##########
####*#####
##########
#####  ###
#####    #
#@$      #
#####.  ##
##########
##########
##########
