##########
###*######
#.  ######
##  ###@##
## ####$ #
##       #
##  ######
##########
##########
##########
