##########
######  ##
######.$@#
######  ##
##########
##########
##########
##########
#######*##
##########
