##########
##########
#  #######
#     ####
#.##$   ##
####@##$##
####### ##
#######  #
####.    #
##########
