##########
##########
#   .#####
#  #######
##$#######
#   ######
#   ######
#  * #####
## @ #####
##########
