##########
#  #######
#    *####
#.#  #####
### ######
### ######
### ######
#@$ ######
##  ######
##########
