###############
#########@#####
#########$#####
# *###### #####
#         #####
# .$ ####.#####
#   ###########
###############
###############
###############
###############
###############
###############
###############
###############
