####################
####################
####################
####################
####################
####################
####################
# ##################
#     ##############
# ##  ##############
# ## ###############
#  # ###############
#  @ ###############
#    ###############
#### ###############
####################
####################
####################
####################
####################
