####################
#########.##########
######### ##########
######### ##########
######### ##########
######### ##########
##        ##########
##  $@##  ##########
####  ##############
####################
####################
####################
####################
####################
####################
####################
####################
####################
####################
####################
