####################
####################
####################
####################
####################
####################
####################
#################*##
####################
#*##################
####################
####################
####################
####################
###  .#  ###########
###  ##   $@########
#### ##  ###########
####     ###########
####  ##############
####################
