####################
##########  ########
##########       $ #
########## ######@ #
########## #########
########## #########
########## #########
########## #########
########## #########
#########  #########
#########  .########
####################
####################
####################
####################
####################
####################
####################
####################
####################
