####################
##########@#########
##########$#########
########## #########
#########  ####  ###
#########         ##
##############.   ##
################  ##
####################
####################
####################
####################
####################
####################
####################
####################
####################
####################
####################
####################
