####################
####################
####################
####################
####################
####################
#########  #########
#########$@#########
######### ##########
######### ##########
########   ###  ####
########        ####
############### ####
############### ####
###############.####
####################
####################
####################
####################
####################
