####################
#      .############
#  #################
## #################
## #################
## #################
## #################
## #################
## $ ###############
## @ ###############
####################
####################
####################
####################
####################
####################
####################
####################
####################
####################
