####################
####################
####################
####################
####################
####################
####################
#####  #############
####   $@ ##########
####      ##########
######### ##########
######### ##########
######### ##########
######### ##########
######### ##########
######### ##########
######### ##########
######### ##########
#########.##########
####################
