####################
####################
####################
####################
####################
#  #################
#  #################
## #################
## #################
## #################
##   ###############
##   ###############
### ################
### ################
### ################
###    @############
### ################
####################
####################
####################
