####################
###.   #############
#####  #############
##### ##############
##### ##############
##### ##############
##### ##############
##### ##############
##### ##############
#####   ############
####@$  ############
#####  #############
####################
####################
####################
####################
####################
####################
####################
####################
