################
##.#############
## #############
##$#############
##      ##.#####
##*####   $#####
###        #####
##@$. ##########
###   ##########
################
