###########
###########
###########
###########
###########
###########
####.######
#### ######
##   ######
##   ##.###
###$     ##
###@   $ ##
####    ###
###########
