########
########
########
#  #####
#@$#####
#  .####
# ######
# ######
# ######
# ######
# ######
# $  .##
#  #####
########
