#################
#  #### .  $@####
#  $      #######
# ###############
# ###############
# ###############
#.###############
#################
#################
#################
#################
#################
#################
#################
#################
#################
#################
