################
## @###  #######
## $## $  ######
### ## .  ######
###       *#####
###.############
################
################
################
################
################
################
################
################
################
################
