    ####
    #@ #
#####  #
#  ##  #
#   $ ##
#   *.# 
####### 