   #####
####   #
#@$  # ###
#. $  .  #
######   #
     #####