   #####
####   #
#@$  # #
#. $  .#
########