##################
#       @        #
#                #
#### #######$#####
#   $            #
#    .      .    #
##################