########
#@ #...#
#   $$ #
# $   ##
#  ####
#  #
####