#############       
#      @    #
#           #
#  $        #
#  .     #  ########
#        #         #
#        #   $   . #
#        #         #
#                  #
#        $   .     #
####################