########
#@ #...#
#   $$ #
# $    #
#  #####
#  #
####