#####
#@$.#
#.$ #
##  #
##  #
#####