################
#      @       #
#              #
#    $ .. $    #
#  $   .. $    #
#    ######    #
#      .$ #    #
#      $. #    #
#              #
#              #
#              #
################