######
#.   #
# #  #
#@$ # 
##  # 
 #### 