          ######         
          # @  #         
          #    #         
###########    ##########
# .    $          $   . #
###########    ##########
          #    #         
          #    #         
  #########    ######### 
  #.     $          $ .# 
  #########    ######### 
          ## $##
           #$.#
           #. #
           ####