#####################
#    . $            #
#                   #
#    . $        @   #
#                   #
#                   #
#####################