#####################
#                   #
#   $    ..    $    #
#               @   #
#                   #
#                   #
#####################