      #######         
      #  @  #         
      #     #         
#######     ##########
# .            $     #
#   $              . #
#######     ##########
      #  $  #
      #  .  #
      #######