      #######         
      #  @  #         
      #     ##########
#######              #
# .            $     #
#   $              . #
#           ##########
#######  $  #
      #  .  #
      #######