#### 
#@ ##
# $ #
#*  #
#   #
#  .#
#####