##############       
#   @        ########
#           $     . #
#   $  .     ########
##############       