    #####
    # @ #
    #   #
#####   ###
#         #
###$#     #
  # #     ####
  #.#  $    .#
  ###        #
    ##########