########   
#@     #
#  $$  #
#  ..  #
########