###############
#     @       #
#             #
#  $  ..  $   #
#  $  ..  $   #
#  $  ..  $   #
#             #
#             #
#             #
###############