#####
#  @#
#   #
#   #
#  $#
#   #
#   #
#  .#
#####