  #####
 ##   ##
##     #
#.     #
### ####
  # #
  # #
  #$#
  #@#
  ###