############
#@         #
#          #
#    $     #
#          #
#        . #
#          #
############