##########
# @ # .  #
#   #    #
#   $    #
#        #
##########