#######
#. #  #
# $@  #
#  #  #
#######