################
#######  #######
###. ##  #######
###      #######
### $ @*  .#####
###  ##$  ######
#######  #######
################
################
################
################
################
################
################
################
################
