#######
#######
##  ###
##    #
#  #$ #
#  .@ #
#######
