##########
###  ##  #
#        #
#  ##### #
## ##### #
## ##### #
## #####.#
##$#######
##@#######
##########
##########
##########
##########
