################
##     #########
##  $@ #########
#####  #########
###### #########
######  ########
######. ########
################
################
################
################
################
################
################
